5 8 8 8 8 8 7 1 1 1 1 1 1 1 1 1
4 2 2 2 2 2 7 1 1 1 1 5 8 8 8 7
5 2 2 2 2 2 9 8 8 8 8 8 2 2 2 7
4 2 2 2 2 2 3 3 3 3 3 3 2 2 2 6
5 2 2 2 2 2 15 10 11 11 11 17 2 2 2 6
4 2 2 2 2 2 6 1 1 1 1 4 2 2 2 6
12 10 10 10 10 10 13 1 1 1 1 4 2 2 2 6
4 8 8 9 8 8 9 8 8 9 8 8 2 2 2 6
4 3 3 3 3 3 3 3 3 3 3 3 2 2 2 6
4 3 3 3 3 3 3 3 3 3 3 3 2 2 2 6
4 3 3 3 3 3 3 3 3 3 3 3 2 2 2 6
12 10 10 10 10 10 10 10 10 10 10 10 10 10 10 13